颈	竟 痉 径 泾 顷 项 口 劲 颌 静 胫 京 经 惊 茎 镜 井 脊 精 景
冠	官 莞 冤 灌 观 蒄 光 㝴 馆 管 贯 关 罐 惯 心 寇
囊	囔 攮 腩 曩 馕 除 壤 襄 蘘 脓 纤 肿 嚢
毓	育 敏 玉 梳 硫 预 流
结	疖 节 径 积 杰 淋 吉 解 接 姐 状 介 睫 低 洁 再 颉 拮 竭 孑 截 膜 诘 捷
痣	值 质 峙 治 痔 枝 志 致 至
荨	浔 寻 荤 荀
部	倍 不 脯 陪 埠 补 布 步 剖 掊 蔀 瓿
跖	拓 砣 石 趾
水	会 木 税 冰 谁 氺 说 睡 破 炎
癌	瘤 线 哀 矮 嵓 砹 艾 嗳 病 疝 埃 皑 爱 唉 留 嵒 品 哎 症 捱 譪 碍 喦 挨
经	今 竟 颈 痉 径 泾 神 晶 近 劲 结 静 睛 胫 京 惊 境 筋 净 茎 镜 动 妈 精 金 景 轻
列	到 烈 裂 链 例 咧 练 冽
甲	贾 价 晚 申 夹 押 假 家 荚 钾 结 加 由
形	射 刑 姓 性 邢 型 行
道	到 艏 路 叨 遁 首 导 倒 岛
痘	都 逗 斗 豆 荳
灸	就 酒 玖 九 久 炙 疚 韮 揪 究 纠 炎
喘	舛 遄 惴 椯 传 踹 湍 船 穿 串 揣 儿 瑞 端
起	齐 期 气 七 超 汽 出 其 上 骑 启
酸	竣 期 狻 黢 俊 算 羧 反 祘 蒜 栓 梭 醋 䝜 酥 拴 比 配
糖	瑭 糠 塘 搪 堂 唐 榶 溏 汤
喉	吼 候 后 侯 瘊 猴
咽	嗯 烟 茵 鼻 胭 因 焰 琰 盐 严 眼 研 延 岩 炎
法	发 去 华 伐 珐
血	薛 学 靴 恤 写 尿 皿 雪 穴 便 削 桖 百 多
怀	幻 淮 伟 还 抔 环 杯 槐 懐 坏
眼	根 言 很 䀶 晚 颜 银 垠 严 艳 跟 胭 验 咽 结 沿 睑 燕 眠 睛 烟 限 演 硍 焰 繁 岩 彦 晴 手 哏 盐 掩 研 跳 艮 炎
炎	言 颜 严 眼 谈 焱 胃 俨 验 琰 咽 胭 沿 儿 期 火 烟 淡 岩 彦 痰 源 炏 盐 研
嗝	隔 镉 膈 各 个 咯 格 阁
窦	都 渎 犊 黏 逗 买 斗 卖 沟 豆 实 抖 头 荳 篼 蔸 心 痘
涕	体 剔 提 滴 锑 梯 啼 剃 悌 弟 第 睇 递 替
肝	苷 感 旰 胖 杆 干 刚 柑 转 赶 甘 杠 盰 酐
近	劲 进 井 斤
膝	鳍 细 析 惜 溪 晞 期 吸 系 汐 稀 息 漆 希 熙 盖 晰 熄 西 烯 滕 悉
类	勒 娄 泪 内 雷 累
脂	值 指 腊 至 溢 炙 支 志 旨 纸 痣 之 肢 酯 植
肪	方 房 仿 妨 昉 放 纺 眆 防
苔	台 笞 胎 抬
疡	殇 样 畅 扬 荡 旸 氧 洋 阳 炀 杨 羊 场 养 馈 痒 汤
胸	忷 淘 兄 凶 哅 恟 匈 雄 洶 熊
镇	震 缜 禛 诊 填 慎 真 朕 振
鼻	濞 不 避 辟 币 碧 脾 必 臂 咽 璧 畀 箅 比 篦 俾 出 壁 闭 息 笔 臭 自 痹
秘	迷 琪 必 蜜 泌 密 谜 米
阴	硬 银 隐 殷 龈 茵 月 音 应 淫 引 阳 丁 鹰 荫 印 因 影 寅
膜	漠 馍 淋 幙 摸 模 莫
圆	员 源 原 元 园
痫	癫 娴 限 闲 疯 鲜
胆	丹 眈 旦 疸 切 弹 掸 蛋 但 单 担 淡
胚	呸 陪 锫 肧 培 柸
胫	颈 径 泾 劲 经 轻
胀	痛 脹 掌 长 仲 涨 脏 张 账 肿 帐
痛	桶 童 铜 甬 胀 风 捅 勇 病 僮 困 酮 疼 烈 庝 佟 通 痈 痌 同
钙	该 盖 概 改 丐
嗽	瘶 簌 授 馊 溯 嗖 壳 擞 欶 嗦 愫 摗 可 漱 凑 搜 蔌
瘤	榴 癌 馏 刘 留 镏 硫 流 溜 遛 廇
梗	哽 硬 挭 更 粳 便 埂 耿
支	质 指 直 至 只 枝 志 肢 吱 之 酯 技 织
腔	枪 前 墙 空 部 啌 强 羫 抢 羌 椌 蔃 羟 控 呛
心	造 信 辛 芯 必 薪 泌 欣 烧 新 锌 鑫 窦 冠 脏 沁
衰	摔 率 甩 哀 帅 蓑 缞
胞	苞 抱 炮 包 泡 孢 饱 鲍
椎	锤 追 淮 稚 柱 盘 缀 锥 间 谁 准
痈	拥 用
肺	杮 非 使 小 肥 废 费 沛 柿 市 啡 蜚 菲 匪 渄 增 沸 肝 斐 悱 杆 飞 腓 妃 绯 脏
核	荷 何 亥 和 该 劾 孩 刻 禾 颌 鹤 盒 合 赫 咳 河 阂
肾	渗 申 故 生 甚 参 慎 神 月 育 胥 审 深 臀 疼 沈 省 坚 升 背 贤 肩 急 晟 呻 唯 身 剩
睛	菁 径 眨 情 晶 婧 静 胫 京 经 惊 境 靖 晴 镜 清 精 研 上
敏	闽 晦 明 悔 酶 每 命 勄 皿 悯 泯 莓 铭 慜 名 梅 毓 抿 民 闵
候	的 猴 喉 侯
障	幛 彰 章 多 瘴 瞕 阻 张 獐 璋 惊 涨 帐 樟 账 漳 胀 嶂
鸡	机 记 及 鸠 积 畸 基 鸟 纪 几 肌 激 急 疾 级
腹	覆 负 傅 幅 肤 部 馥 浮 附 复 服 宫 俯 妇 摸 副 腑
疝	氙 气 膻 膳 山 讪 仙 闪 善 汕
气	齐 期 七 汽 部 起 欺 疝 皮 子 其 弃 器
能	㴰 螚 熊
晕	雲 氲 昏 运 旱 芸 眩 晖 熨 愠 殒 荤 孕 云 陨 匀 军 婚 車 车 悬 暈 恽 韫 蕴 韵
嘶	斯 撕
剖	刨 倍 陪 部 抔 掊 培 剥 抛 婄 破 棓
育	不 郁 昱 运 预 止 予 俞 月 欲 逾 浴 余 遇 孕 渔 缓 全 瑜 雨 裕 宇 玉 良 背 域 盲 愈 与 御 于 禹 於
避	必 辟 币 弊 蔽 僻 壁 薜 毕 敝 璧 闭 劈 癖 逼 比
溃	贵 奎 愧 亏 馈 匮
裂	挒 烈 劽 姴 例 列 洌 袭 咧 劣 冽
巴	把 芭 移 吧 结 疤 八
肌	鸡 饥 机 交 击 及 积 脊 基 集 几 极 激 急 疾 叽
管	到 官 道 赌 视 观 灌 馆 冠 菅 关 尿
搏	博 波 膊 薄
维	惟 唯 超 韦 魏 锥 伟 薇 性 卫 微 萎 委 为 围
肿	腺 胖 中 祌 种 钟 重 冢 脓 仲 囊
栓	酸 拴 检 全
慌	谎 皇 黄 晃 荒 惶
下	方 卡 峡 卞 卜 吓 上 夏 睑 丅
征	挣 症 正 蒸 证
倒	到 道
耵	酊 盯 叮 订 钉 丁
聍	拧 宁 柠 咛
包	刨 胞 报 笣 苞 抱 爆 宝 疱 皮 泡 薄 孢 剥 饱 鲍 保
皮	发 波 疲 匹 屁 易 脾 坡 劈 包 啤 癖 披 批 坯
烧	邵 挠 绍 搔 娆 浇 心 焼 芍 勺 稍 绕 捎 骚 饶 少 尧 哨 梢 臊
肠	玚 唱 疡 常 畅 旸 长 胃 尝 杨 场 汤 胀
性	里 生 心 氏 维 刑 胃 弱 姓 律 缺 兴 行 吸 形 锌 值 信 腺 症 菌 型
贴	铁 萜 沾 粘 帖
生	胜 节 牲 化 省 升 声 身 圣 性 笙
型	形 刑 姓 性 邢 行
检	捡 监 减 剑 键 间 俭 验 碱 见
肛	屁 刚 缸 岗 工 江 肝 钢 杠 纲 肚
苍	仓 沧
胎	钛 跆 肽 台 怡 态 枱 太 苔 抬
宫	攻 官 拱 宮 肱 空 缩 工 公 吕 巩 供 功 共
错	搓 措
胱	桄 咣 光 广 恍 洸
齿	翅 斥 池 牙 齒 迟 啮 赤 列 豉 尺 淞 耻 驰 弛 吃
疫	异 预 役 瘟 亿 育 抑 一 艺 疾 设 宜 意 殁 咦 溢 以 移 投 仪 译 医 噫 义 毅 没 易 亦 益
脓	胧 农 侬 哝 隆 肿 浓 帐
腺	馅 现 线 县 显 泻 险 闲 鲜 献 性 藓 纤 脉 陷 岘 限 泉 屑 泄 甲 隙 贤 廯 缐 房 涎 先 葲 械 瑔 痫 腥
菌	钧 蔨 郡 均 俊 珺 b 君 染 箘 性 军 茵
拔	拨 把 靶 巴 菝 吧 管 八 跋 扒 抜
落	洛 脖 涝 络 罗 捞 烙
镜	竟 睛 胫 晶 颈 敬 径 精 景 近 经 竞 境 进 靖 静 净
清	晴 请 氢 精 情 淸 倾 青 轻
c	x 吸 t d m G a C o s v e
抗	坑 炕 杭 亢 伉 表 扛 康 抵
根	梗 跟 更 恨
隆	龙 胧 降 窿 湰 垄 癃 弄 拢 脓 聋 陇 笼
扎	轧 诈 炸 渣 札 匝 咋 咂
褥	辱
茎	胫 晶 颈 痉 京 径 镜 精 泾 劲 经 惊 丁 筋 轻
康	糠 慷 炕 扛 抗
登	等 噔 灯 蹬 瞪
便	鞭 血 边 编 变 硬 辨 更 梗 粳 鞕 遍 埂 辫 偏 扁
涨	张 胀 帐
化	画 早 吪 话 液 生 华 花 划
疙	隔 圪 割 膈 哥 各 乞 个 咯 讫 格 噶 歌 阁 旮
苋	现 见
疟	瘧 虐
闷	门 焖 扪 闹 悶 们
瘫	谈 袒 摊 傩 坦 滩 难 贪 儿
频	頻 平 品 瓶 颦 聘 濒 拼 贫 眼 蘋
恶	厄 鳄 俄 呃 额 噁 鹅 噩 悪 饿 垩 儿
烂	乱 拦 澜 蓝 兰 栏 滥
瘦	寿 膄 叟 绶 授 馊 廋 痩 首 受 嗖 收 兽 搜
燥	造 躁 澡 璪 藻 灶 噪
视	矢 湿 是 室 似 示 市 观 势 实 式 识 适 饰 试 管 逝 失 见 时 智 事
疣	优 莜 庞 厐 旁 莸 犹 疮 尤 忧 又 由
急	即 记 机 及 季 积 集 极 肌 呼 激 疾 级
斑	搬 癍 版 板 半 丘 瓣 瘢 班
稠	愁 抽 丑 椆 仇 调 绸 酬
痔	诗 制 只 痣 至 酯 庤 汁 指 峙 知 侍 炙 持 志 致 值 质 手 治 智 寺
梅	酶 每 眉 嗨 海 没 美 霉 莓 枚 悔
恙	痒 阳 羕 羌
症	镇 政 正 病 整 郑 性 征 证
畸	奇 积 琦 纪 挤 机 亟 级 骑 剂 寄 肌 齐 济 及 崎 基 几 极
尿	脲 杘 水 潜 鸟 袅 拔 尻
期	琪 气 妻 棋 七 秘 汽 起 欺 亢 其 器 斯 旗
压	牙 圧 崖 呀 高 押 鸭 芽 吖 庄 皿 丫 亚
屁	疲 匹 辟 芘 脾 枇 劈 皮 痞 庇 癖 披 毗 比 批
流	瘤 琉 蓅 六 梳 刘 出 留 硫 清 淌 溜
癜	颠 电 癫 巅 殿 点
庭	廷 亭 厅 挺
萎	为 危 韦 谓 瘘 胃 微 委 伪 痿 围
摩	魔 摸 模 莫 磨
胃	肠 未 卫 肙 为 痿 围 贵 月 魏 谓 维 冒 畏 姓 胄 惟 火 喂 位 味 甲 萎 渭 唯 韦 微 委 尾
暑	书 薯 属 署
碳	1 痰 谈 炭 摊 氮 叹
1	4 i l . 一 I
4	1 碳
试	时 式 湿 是 市 适 使 事 轼 室 实 拭 食 示
痰	啖 菼 谈 炭 倓 摊 锬 毯 谭 淡 炎
阑	烂 懒 澜 岚 蓝 阐 南 兰 柬
蛭	至 侄
塞	瑟 死 赛 色 噻 脉 涩
底	抵 氐 地 坻 低 第
7	1 七
葡	莆 铺 埔 浦 蒲 匍 普 谱 圃
萄	掏 淘 逃 匋 陶 桃
肤	扶 肽 芙 复 服 妇 夫 付 副 朕
积	奇 计 纪 激 只 畸 挤 吉 轵 机 和 继 炽 集 结 枳 疾 级 织 即 知 肌 急 汲 鸡 记 击 及 玑 帜 脊 基 迹 几 极
泻	谢 屑 泄 写
疱	刨 袍 胞 苞 抱 庖 炮 包 泡 孢 跑
拨	波 拔 坡
粘	站 沾 占 黏
肟	污 圬 窝
副	福 辐 富 负 幅 腐 附 复 付
孩	亥 嗨 害 还 海 坏
进	劲 近 井
腰	妖 扭 要 膘 漂 幺 瑶 偠 夭 药 邀
脐	漆 齐 鳍 琪 机 鸡 济 系 七 剂 期 歧 汽 及 其 奇 荠 挤
张	章 胀 长 障 涨 脏 樟 账 帐
籽	杍 仔 子 梓 吇
体	型 本 提 抵 题 缇 梯 剃 躰 骵 泍 休 啼 面 剔 我 启 替
疼	痛 冬 肾 誊 庝 佟 红 疯 痋 腾 剧 藤 滕
曲	取 去 区 屈 宽 蛐 驱 由
口	前 叩 呕 足 扣 日
嗳	爱 暧 唉 暖
腿	退 褪 脚 忒 推
肚	吐 独 社 土 度 堵 笃 渡 肛 杜
嗜	湿 是 痴 者 示 鲺 蓍 啫 实 噬 式 适 饰 试 稽 食 逝 失 事 耆 誓 蚀
石	时 右 识 式 湿 是 口 耳 屎 实 十 食 示
乙	己 衣 亿 以 胰 已 一 仪 艺
肋	类 勒 内 垒 胁 磊 力 助 嘞 累 胸 筋 內 肍
睾	皋 睪 膏 幸 羔 辜 稿 皐 高 搞 髙 囊
欲	郤 裕 郁 俗 浴 鱼 愈 预 与 渔 于
钾	里 价 胛 假 甲 加 岬
直	值 指 只 支 纸 制 真 性 植
杷	把 巴 琶 吧 耙 爬
并	病 丙 开
颅	胪 卢 泸 卤 芦 鸬 颈 路 庐 戮 炉 损 鲈 驴 户 露 脑
周	舟 粥 肘 稠 围 州 轴 啁 椆 同 洲 週 园
混	棍 浑 湿 婚 魂 昏 馄
眩	晕 昡 悬 旋 炫 铉 玄
氟	福 富 伏 弗 浮 复 夫 副 佛 拂
桃	掏 逃 姚 兆 导 陶 挑 套 狣 跳 条 儿 脑
酒	就 酉 九 久 氿 洒 玖
腋	叶 掖 业 液 烨 夜
荡	当 宕 档 裆 汤
哮	消 校 晓 小 笑 孝 效 销 哓 啸
艾	爱 哎 癌 唉 哀 挨
姜	绛 将 浆 蒋 江 疆 美 葁 羑 酱 羌 羹
脾	疲 卑 埤 碑 皮 啤 癖 婢 披 毗 睥 批
静	睛 竟 胫 敬 颈 镜 动 径 腈 精 靓 近 劲 经 境 筋 靖 净
偏	翩 片 编 便 谝 遍 篇 扁 骗
房	方 芳 下 仿 范 妨 旁 坊 部 放 肪 防
脚	交 角 椒 狡 轿 拇 腿 搅 软 跤 前 娇 觉 胶 叫 却 蛟 较 绞
疸	恒 旦 胆 横 但
乳	濡 奶 孔 孺 汝 褥 浓 浮 鲁 良 辱 儒 茹 如 入
哌	派
播	拨 玻 波 搏 啵 传
散	三 霰 播 伞 叄 潵 闪 撒 澈 斯 馓
诊	临 昣 帧 症 胗 珍 疹 证
寺	痔
同	酮 童 桐 通 洞 铜 僮 冋
关	官 观 部 馆 冠 贯 管 夫 天 棺 半
鼓	姑 谷 骨 股 故 豉 咕 古 鼔 锢
泄	协 屑 写 绁 卸 泻 谢 些
止	指 趾 直 址 治 至 支 外 职 枳 芷 只 之 上
糜	迷 秘 泌 腐 觅 靡 密 谜 米 弥 磨
肢	吱 指 只 支 枝 技 之
习	息 系
冒	昌 胄 茂 冐 貌 胃 瑁 帽 猫 毛
备	倍 呗 各 碑 背 惫 被
癣	先 酰 限 鲜 选 藓 贤 廯
廓	漷 扩 阔 郭
脸	莲 怜 捡 裣 联 链 俭 潋 殓 验 敛 连 练 睑 检
闭	必 避 币 弊 闲 壁 毕 璧 庇 比
达	哒 打 答 大
涩	瑟 色 塞 忍 涉
髓	隋 隧 随 碎 瓍 隨 椭
p	屁 a b q o v P
脊	己 肾 机 冀 剂 藉 及 积 嵴 稽 瘠 几 肌 背 急 挤 棘
卒	猝 族 倅 碎 萃 率 组 箤 促 足
瓣	班 掰 辩 绊 癍 辨 办 伴 辫 辬 脉 半 辦 斑
力	里 离 立 刀 利 万 粒 历 劲 李 理 训 藏
孢	刨 胞 苞 抱 炮 包 铇 泡 饱 鲍
恼	脑
娠	晨 辰 振
虚	热 需 虎 恤 胥 徐 许 嘘 续 虑 须
感	传 严 咸 赶 病 撼 创 泔 干 澸 憾 肝 杆 尶 惑 盛 真 敢 鳡
唑	做 坐 锉 咗 挫 座
赖	濑 莱 懒 来
瘢	班 搬 癍 痕 疤 斑 般
襄	曩 馕
抑	异 迎 役 亿 疑 已 一 忧 宜 意 咦 溢 以 忆 移 奕 仪 谊 疫 卯 噫 医 印 毅 仰 易 亦
丙	炳 内 冰 病 二 饼 秉 并
泊	伯 勃 他 迫 柏
低	底 滴 邸 氐 声 地 回 堤 坻 第 抵
缺	蒛 却 缸 卻 阙 炔 块 伤 蚗
硬	哽 银 应 更 便 梗 映 埂 英 阴 萦 粳 影 引 蝇
曩	囊
痉	茎 胫 颈 净 径 京 精 泾 劲 经 筋 轻
微	惟 危 唯 韦 谓 维 胃 未 薇 威 可 伟 委 为 徽 围
怡	抑
足	兄 手 是 族 口 阻 脚 组 卒 哫 租 促
溢	噫 义 一 益 脂 宜
扁	边 编 匾 便 遍 偏 篇
疹	镇 昣 帧 症 诊 胗 证 珍 真 枕 针
带	有 滞 岱 袋 代 呆 堵 戴 待 怠 百
样	扬 祥 佯 像 洋 仰 阳 羊 漾 养 痒
风	痛 锋 岚 封 讽 疯 砜 冈 凤 丰 峰
发	拨 法 發 罚 乏 泛 友 不 迟 手 小 叐 花 伐 皮 沷 拔 犮
潮	朝 超 抄 嘲
供	攻 拱 公 洪 共
地	抵 底 他 哋 滴 坻 的 帝 弟 低 第
原	员 源 愿 缘 圆 援 元 园
补	䃼 扑 不 部 布 步 捕 卟 朴 卜
脑	电 纳 老 脳 佬 后 闹 小 恼 劳 颅 捞 头
输	述 腧 速 渝 叔 束 蔬 梳 数 舒 属 偷 术 疏 署 书 俞 輪
精	不 竟 菁 径 神 青 晶 腈 婧 棈 劲 静 睛 请 胫 京 经 惊 境 靖 净 茎 晴 镜 清 景 索
脉	咏 脈 买 麦 霡 塞 卖 泳 迈 永 辦 劢 唛 索
骨	滑 嗗 固 姑 谷 股 馉 故 鼓 肯 盆 蓇 古 创
脏	臧 桩 账 賍 心 庄 暂 涨 臓 影 藏 赃 胀
痒	徉 痱 样 疡 庠 烊 扬 牙 用 佯 氧 洋 仰 阳 羊 杨 养
磺	潢 皇 黄 璜 簧 煌
汀	盯 订 町 钉 厅 丁 玎
友	有 朋
狭	下 侠 霞 夹 硖 峡 挟
逆	拟 匿 你 倪 尼
状	节 狀 妆 撞 肿 装 壮
坐	做 左 唑 挫 座 作
平	苹 瓶 千 频 坪 凭 屏 评 萍
植	值 指 直 脂 殖
质	支 旨 制 只 痣 至 酯 脂 指 直 置 枝 栀 头 知 志 纸 值 治 智 执 之
智	支 旨 制 痣 只 至 脂 指 直 置 枝 枳 知 志 肢 值 质 稚 治
锁	琐 所 唢 缩 嗦 梭 索
疮	床 腔 仓 术 苍 瘡 怆 窗 创
湿	始 矢 是 室 诗 显 示 史 施 实 师 式 试 士 失 时 舌 事 石 屎 温
竭	孑 揭 截 羯 洁 节 歇 褐 接 颉 渴 结 端
白	厚 百 拜 败 自 柏 曰 日
隔	镉 膈 搁 各 革 个 嗝 格 歌 阁
硝	消 销 小 肖
胖	厐 庞 膀 旁 泮 磅 伴 滂 肨 拌 半 螃 肿 眫
氯	隶 录 滤 氨 碌 率 绿 律
鼾	憨 邯 杆 干 寒 鼻 旱 肝 悍 瀚 汗 酣
舒	述 姝 淑 束 鼠 术 叙 梳 属 数 书 疏 抒 叔 输
酚	份 芬 氛 分 粉 汾 吩
万	完
利	里 莉 丽 离 立 例 俐 力 历 粒 李 黎 梨 厉 痢
圈	权 全 泉
反	返 酸 饭 烦
黄	方 谎 磺 潢 慌 皇 璜 典 晃 簧 荒 煌
膨	砰 彭 碰 嘭 鹏 澎
病	痛 感 炳 症 冰 丙 柄 饼 征 兵 并
巨	臣 矩 句 据 聚 拒 距 拘 具 剧 局
规	贵 硅 观 瑰 柜 归
兰	蓝 拦 栏
膊	波 脖 傅 博 搏
磁	辞 慈 次 此 瓷 兹 词 糍 滋
屎	始 矢 湿 是 使 十 示 尿 杘 史 尸 实 式 色 试 阴 食 尻 失 时 石 事
子	孑 字 淄 了 通 兹 自 仔 孖 孕 吇 籽 枕
割	隔 搁 哥 害 豁 革 各 嗝 格 哿 歌 划 戈
暮	幕
昏	晕 浑 混 婚 魂 荤 运
出	触 除 础 楚 鼻 初 处 山 流
朵	哆 道 躲 哚 部 跺 杂 垛 剁 夺 多
更	哽 硬 庚 梗 便 埂 耿
腮	缌 赛 塞 思 鳃
克	1 咳 兢 乐 壳 科 刻 可 皮 课 颗 柯 客 疴
失	矢 湿 是 使 诗 示 氏 市 史 施 实 师 式 试 士 时 视 佚 石 关
融	容 溶 瀜 熔 绒
喷	濆 喯 噴 湓 盆 奔 贲
醉	罪 卒 酔 最
痂	加 伽 迦 夹
肥	把 靶 匪 悱 非 飞 腓 粑 废 淝 较 沸 斐 绯 费 耙 肿 肺
贫	平 品 频 嫔 盆 娦 凭 拼 贺 贸 贤 评 貧
亚	业 牙 芽 娅 压 丫 哑 並
内	肉 类 馁 部 讷 丙 芮 氝 抐 㐻 那 內
染	渠 燃 冉 毒 然 媣 蒅 梁 面 菌 柒 炎
掌	章 丈 瘴 幥 涨 党 礃 张 仗 常 帐 杖
胳	隔 歌 哥 各 个 咯 格 铬 肐
碎	谇 绥 隋 税 隧 卒 翠 脺 淬 随 岁
挫	措 坐 唑 锉 搓
淋	林 巴 转 啉 琳 凌 冧
驱	区 祛 躯
再	冉 在 结
季	即 机 寄 及 积 秀 集 悸 李 级
绞	交 跤 骄 角 铰 脚 姣 狡 佼 较 胶 搅 饺
纤	先 千 限 酰 线 仙 仟 阡 钎 显 迁 囊
婴	樱 音 应 缨 影 嘤
手	发 瘦 守 授 口 传 首 受 眼 收 毛
蚣	公 共
药	妖 湿 膏 要 窈 芍 幺 姚 约 模 摇
渴	揭 喝 可 刻 课 竭 咳
眠	珉 抿 䀶 缅 冕 免 岷 棉 㬆 民 绵 眼 面 娩 呡 泯 勉
己	已
臂	肾 必 避 辟 币 弊 蔽 壁 薜 毕 璧 闭 臀 比 笔
粥	州 弼 周 洲
帕	怕 袙 帊
磷	林 遴 膦 鳞 琳 璘 麟
缔	谛 第 帝
兆	垗 照 孕 挑 狣 找 赵 肈 召
阻	诅 狙 组 租 祖
滞	质 治 支 光 塞 止 制 致 带 至 酯
妊	壬 任 仁
富	副 复 负
侧	册 则 厕 测 恻 铡
退	腿 推 低 褪
振	震 赈 共 珍 真 证
唇	纹 春 㫳 蜃 醇 辰 滣 脣 晨 淳 纯
邦	绑 帮
液	掖 叶 页 业 腋 精 也 夜
露	霜 录 卢 鹿 路 漏 鲁 璐
胰	眱 亿 咦 脾 夷 一 仪 乙 姨
茨	兹 咨 次 子
澡	早 躁 藻 燥 噪
良	量 育 亮 凉 浪 梁 乳 两 谅 粮 艮
搐	畜 蹰 触 处
牙	乐 呀 齿 芽 伢 压 蚜 雅 厊 亚 痒
寒	憨 赛 害 汉 塞 含 旱 涵 汗 韩 喊
酮	痛 桶 筒 痌 桐 侗 通 醇 铜 眮 同 彤 烔
撤	撒 澈 扯 辙
瘙	骚 搔 蚤
浆	将 液 奖 江 桨 酱 姜
躁	噪 澡 燥 操
菠	波 啵
增	赠 缯 迂 蹭 曾 増 憎 加 肺
屑	血 疖 屃 宵 痟 肖 泄 写 雪 卸 削 泻 谢
激	积 际 徼 挤 邀 机 继 集 级 檄 稷 剂 缴 稽 肌 急 鸡 击 及 基 几 极
萝	锣 罗
髌	冰 膑 槟 滨 宾 缤
钠	呐 纳 那
霉	酶 每 毒 没 美 梅 莓
神	肾 绅 伸 森 申 什 省 精 甚 审 生 运 经 身 深 圣 剩
二	丙 而 2
项	㑔 相 颈 向 像 象 贡 顶
茶	涂 搽 查 嗏 差 察 荼 叉
酞	钛 太 肽
死	撕 塞 四 私
腭	颚 鳄 萼 额 饿 鄂 愕
异	役 亿 抑 导 已 一 邑 宜 意 咦 以 移 仪 疫 义 易 亦 益 乙
洛	络 各 落 咯 罗 珞 烙
髋	款 胯 梡 鑧 骻 宽
推	退 褪 锥 堆 蓷 椎 颓 准
螺	啰 洛 骡 摞 裸 罗 累 镙 萝
隐	瘾 稳 印 荫 银 应 因 癮 引 阴 饮 隠 影 龈 寅
薏	意 噫
铁	蛈 秩 跌 鉄 锈 萜 佚 轶 帖 贴 失
钯	靶 把
树	书 术 村
腓	菲 排 匪 非 绯
粪	龚 份 糞 分 愤
常	嫦 厂 畅 赏 长 肠 尝 带 场
d	a b c p D 低 6
颤	婵 铲 擅 膻 产 战 馋 缠 儃 阐 站 湛 禅 澶 檀
痿	娄 喽 伟 楼 萎 委 偎
股	姑 谷 故 役 嫴 蓇 般 设 骰 骨 殁 投 双 肢 固 鼓 没 古 菇
蚊	文 纹 吻 汶 温
桥	轿 乔 俏 侨
虑	虎 滤 虙 率 虚 绿 氯 虏 律
柿	是 市 铈 事 石 肺
女	吕
氨	胺 铵 按 安
蜂	锋 蜜 封 烽 峰
凤	风
菊	举 掬 句 据 桔 橘 局 鞠
戊	物 戌 戍 五
左	做 右 坐 佐 咗 作
电	龟 癫 店 殿 碘 动 点 典 甩 钿 脑 垫
高	蒿 皋 告 膏 亮 篙 镐 压 稿 搞 髙
颊	颈 下 夹 侠
按	胺 铵 桉 摁 安 案
身	渗 肾 沈 射 伸 申 生 甚 良 参 声 升 神 深
廷	挺 庭
缝	锋 逢 风 封 峰 奉 冯
蒲	葡 铺 埔 浦 普 谱
线	浅 岘 腺 先 限 酰 现 闲 衔 鲜 钱 县 显 贱 纤 饯 缐
凉	量 亮 京 涼 粱 良 梁 惊 琼 谅 两 晾 粮
慢	缦 曼 满 快 漫
西	酉 希 吸 系 昔 夕 锡 稀 细 茜 息 硒 晞 洗
声	节 省 生 升 结
疤	把 巴 笆 瘢 吧 芭 班
头	发 质 透 部 偷 斗 太 大 投 頭 脱 条 骰
甜	舔 填 恬 田
胍	瓜 弧 呱
瘘	溇 偻 篓 搂 娄 喽 委 漏 嵬 楼 蒌 露 萎 缕 痿
澳	奥
际	机 及 继 迹 寂
健	碱 腱 键 建
间	涧 简 键 建 捡 监 渐 坚 件 尖 兼 奸 椎 健 问 肩 锏 见
啦	拉
刺	辞 质 次 呲 嗽 朿 茨 莿 庛 剌 此 磁 棘 敕 喇
人	任 亻 认 个 仁 入 大
孕	匀 晕 雲 育 玉 哥 昱 运 子 尕 御 愠 云 蕴 韵 氖 乃
睡	锤 不 脽 税 唾 捶 水 碎 谁 娷 随
鸣	袅 鳴 命 名 銘 呜 鸟 洺 民 明 铭
酐	杆 干 鼾 酑 肝 甘 秆 盰
b	必 d 链 闭 p B 比
敷	孵 覆 傅 缚 氟 浮 附 辅 复 服 腹 俯 夫 敖
术	述 树 统 速 木 沭 暑 袋 数 书 怵
拆	豺 斥 折 柴 差
玻	波 泼 博 菠 坡 啵 皮 薄 破 柏
滋	兹 资 爱
髁	果 棵 颗 粿 踝
损	员 孙 笋 殒 顺 修 性 挫 伤 陨 損
优	呦 犹 尤 忧 又
妇	期 副 扫 富 负 父 肤 复 腹 夫 付 归
卵	卯 鸾 乱 暖 栾 印 挛 脔 峦 孪 软
室	始 时 式 湿 氏 是 适 市 事 释 石 世 试 实 示 至 窒
骚	搔 瘙 臊
枇	皮 批 琵
折	斥 则 斤 拆 择 这 辙 近 者 着 哲 浙 柘
嗦	索 唢 嗽 嗖
咳	咔 亥 磕 该 孩 壳 科 刻 可 渴 咯 克 禾 嗑 晐 客 核
臀	吞 殿 臂 囤 壁 臋 鲀 豚 屯
彩	踩 才 婇 采 蔡 菜 四
龟	贵 电 鲑 硅 亀 鱼 瑰 鬼 归 桂 规
纹	文 蚊 玟 汶 温 唇
颌	颚 何 和 项 颏 颈 额 禾 頜 合 核 鸽
板	版 伴 饭 极 扳 坂 返 班 拌
迟	发 池 痴 尺 缓 弛 吃
潴	储 猪
韦	魏 惟 伟 苇
肱	攻 耾 竑 躬 工 公 功 宏 厷
腕	婉 碗 挽 宛 豌
垂	锤 吹 捶 倕 娷 睡
劳	労 老 捞 牢 唠
滤	率 虑
珠	朱 姝 柱 住 蛛 株
右	有 左 友 编 石 铀 又 由 佑
置	值 直 罩 治 支 职 制 致 至 植 织
计	机 汁 记 寄
龙	尢 垄 咙 泷 珑 拢 弄 隆 尤 聋 陇 笼
凸	凹 突 图
中	值 哺 祌 忠 钟 种 终 重 肿 仲
司	饲 思 斯 四 撕
脱	退 陀 税 唾 说 蜕 落 悦 突 鸵 锐 剥 拖 兑 拓 托
素	速 毒 粟 诉 俗 簌 碎 麦 苏 数 肃 愫 宿 塑 涑 索
滑	骨 话 化 华 花 猾 划
降	犟 绛 将 姜 奖 蒋 隆 酱 阵 讲
验	彦 燕 言 艳 捡 烟 演 俭 厌 试 敛 眼 研 雁 检
腱	剑 键 建 尖 健 见
雾	乌 霜 伍 无 霾 霚 物 务
查	杳 渣 碴 差 察 香 査 插 茶
败	拜 百 柏 白
酯	纸 指 旨 脂
芬	酸 份 酚 分 汾 吩
奶	㚫 仍 扔 乃 来
功	攻 官 工 公 宫 供 玏 共
架	驾 家 价 加
柱	主 锥 驻 助 椎 注 住
贲	喯 粪 锛 喷 愤 奔
迫	伯 追 坡 泊 怕 性 破 珀
正	症 整 止 征 证
亢	期 炕 吭 航 伉 扛 抗 康
扭	杻 钮 腰 牛 拗 妞 丑 纽 来
刮	乱 挂 清 瓜 剐 划
阿	额 鹅 艾 啊
眶	匡 狂 框
泌	迷 必 秘 祕 宓 密 米 沁 心
卜	拨 不 播
悸	季 急 挤 激
羊	样 水 佯 氧 洋 仰 阳 丰 杨 养 痒
叶	掖 汁 页 业 液 腋 也 经 烨 旪 夜
跳	逃 朓 兆 挑 调 眼 桃 眺
袋	道 术 代 袭 贷 带 待
像	想 向 象 相
吐	涂 图 钍 兔 土 凸 突
晒	洒 哂 西 筛 硒
佳	家 荚 甲 桂 加
定	腚 淀 订 锭 啶 钉 丁 顶
孔	轧 恐 空 子 扎 控
量	辆 亮 凉 良 谅 两 练 晾 粮
巩	拱 肱 矾 宫 共
密	迷 泌 秘 蜜
睑	捡 俭 茧 验 敛 碱 脸 上 检
癫	颠 巅 殿 痫 癜
紫	紧 兹 自 子 梓 柴 吇 籽 絮 滋
疗	期 了 辽 序 聊 料 助
淤	瘀 余 遇 与 预 予 于 於
勃	拨 早 波 脖 博 搏 渤 荸
理	里 离 锂 例 力 哩 礼 李 埋
节	疖 生 解 疥 接 姐 兯 劼 回 结 低 洁 颉 界 劫 孑 腺 阶 捷
肩	月 交 键 建 捡 监 剑 间 弹 腱 坚 尖 兼 健 护 碱 见
沟	够 抅 勾 苟 狗 购 钩 构
建	键 健 见
剂	即 记 机 济 及 计 基 极 技 挤
环	不 还 怀 抔 杯 换 焕 缓 欢 坏
尘	陈 尖 沉 晨 辰
游	漩 友 蝣 犹 尤 忧 又 由
酶	每 没 梅 美 霉 莓
韭	就 酒 匪 菲 非 久 韮
膀	帮 胖 绑 磅 旁 傍 滂 棒 榜 镑 徬 螃
杆	干 肝 杄 杠 敢 秆 盰 酐
阳	样 扬 旸 佯 氧 驲 日 洋 阴 仰 羊 杨 鈤 炀 性 养 痒 炎
攻	公 功
嗓	磉 搡 噪 桑
淫	吟 瘾 银 因 引 龈 寅 婬
疯	枫 风 凤
息	希 吸 恳 洗 系 昔 媳 熄 悬 夕 自 稀 细 栖 习 西 悉
变	鞭 编 便 挛 変 遍 粗 大
大	打 变 人 太 便 犬 脚 天 搭 答 达
铋	必 秘 泌
磨	膜 魔 蘑 摸 模 摩 墨 莫
鞘	消 俏 撬 壳 悄 肖 销 憔 削 稍 峭 翘 乔 梢
袖	岫 抽 柚 秀 轴 绣 休
味	有 惟 唯 谓 妹 胃 未 位 萎 为 昧 抹
渍	责 字 子 滋 啧
他	它 泊 她 地
鳞	林 磷 膦 琳 璘 麟
瘊	候 猴 侯
诺	锘 喏 偌 若
缓	暖 媛 育 迟 授 还 援 环 桓 唤 焕 换 嬛 患 锾 欢
跟	根 限
蚤	骚 搔
殇	疡
韧	任 刃 肕 人 纫 认 轫 仁 忍 仞
芪	奇 齐 氏 岂 萁 芩 祁 其 汔 荠 祇
崎	奇 嵜 汽 琦 畸 骑
授	收 受 援
疏	琉 梳 蔬 鼠 术 舒 酥 流 漱 书 输
德	的 徳 得
仑	轮 论 伦
溶	容 蓉 熔 榕 融
林	临 磷 啉 琳 淋
马	乌 玛 吗 嘛 码
霰	缐 散
苷	咁 甘 柑
泡	刨 袍 胞 苞 抱 庖 疱 炮 包 咆 跑
瑞	睿 锐 端
绵	棉 面
尤	优 疣 犹 尢
溏	塘 糖
臭	杻 牰 殠 愁 抽 嗅 溴 丑 㚖 仇 瞅 筹 臬 凑 绸
山	三 删 杉 衫 善 闪 汕
嗪	榛 溱 晴 秦
坦	谈 旦 坛 袒 摊 探 胆 昙 但 担 钽
角	交 甪 叫 缴 觉 教 脚 娇 较 胶 搅 绞 矫
森	神 斯 身
继	及 即 激 断
欣	辛 昕 新 欢 心
吸	汲 希 气 析 系 昔 及 迫 夕 稀 细 习 极 西 息 级
细	希 吸 洗 系 戏 佃 钿 病 惜 习 西 田
耐	奶 奈 耏 乃
酵	敎 叫 教 哮 孝 较 胶
震	振 镇 症 诊 阵 针
芽	伢 呀 牙 厊
胶	交 跤 校 角 童 股 郊 脚 姣 蛟 狡 较 绞
快	块
猝	碎 萃 卒 促 淬 捽
橡	象 像
盖	膝 该 蓋 部 概 改 垓 钙 丐
踪	棕
介	洁 价 接 节 借 界 芥 个 阶 结 届
蛋	丹 旦 胥 蚕 弹 胆 单 但 淡
氧	样 氢 扬 仰 洋 氯 羊 阳 杨 养 痒
屈	曲 去 躯 区
龋	蛆 蝺 蛀 龃 龄 曲 齿 取 啮 去 踽 属 娶 蜀 屈 禹 驱 齲
态	酞 抬 太 肽
a	A d e b i q 啊 o s α
勺	邵 烧 芍 海 绍 哨 匀 少
应	硬 英 映 影
综	踪 棕 中 总 宗 粽
厚	候 后 侯 白 齁
满	瞒 蛮 曼 慢 螨 漫
官	观 馆 管 宫 功
檬	蒙 濛 猛
窒	至 室 制
蛾	饿
度	毒 席 症 渡 读 镀 杜
潘	番 盘
外	下 万 处 止 崴 歪
饿	锇 俄 呃 恶 额 鹅 我
真	值 振 感 镇 直 甄 诊 珍 针
疾	鸡 即 机 矢 及 急
接	皆 节 结 揭
枸	够 句 苟 狗 拘 购 钩 构
球	求 俅 丘 逑 秋 菌
蒡	榜 旁
铅	前 千 钳 签 钎 沿 迁
松	菘 齿 凇 醇 公 颂 淞 送 宋 怂 讼
男	南 难
踝	淮 裸 裹 壊 怀 果 褢 槐 棵 课 馃 櫰 坏
制	值 质 直 置 治 志 执 致 至
弥	你 迷 猕 祢
鳖	弊 憋
罐	官 灌 馆 管 惯
后	骺 厚 喉 时 垢 右 候 石 侯 洉 脑 逅
纵	枞 从 踪 棕 重 宗 众
共	振 供 功
赛	塞 噻
门	们 扪 闷 眼
瘀	郁 余 于 淤 於
汗	焊 罕 杆 干 寒 涵 憾 汉 旱 含 扞 汘
黏	年 膜 粘
复	福 符 扶 富 负 傅 馥 敷 腹 服 付 夫 副
令	玲 零 林 今 岭
传	转 专 川 船 穿 痣
馄	混
狐	胡 弗 孤 妇 呼 弧
痴	慈 知 迟 齿 疵 吃
颚	鳄 额 腭 饿 鄂
半	干 办 伴 拌 班
抖	都 钭 逗 陡 斗 科 豆
多	哆 梦 血 躲 夕 铎 障 剁 跢 朵
未	末 味
青	晴 请 箐 腈 清 情 轻
消	俏 校 宵 硝 小 肖 销 笑 孝 逍
脖	波 勃 悖 钵 博 泊 落 跛 渤 浡 荸
搭	答 塔 嗒
睫	婕 捷 节 结
级	及 机 极
百	摆 败 佰 白
聋	龙 耳 咙 泷 弄 隆 陇 耷 笼
服	福 缚 复 腹 敷 夫 付 副
舌	蛇 摄 吉 适 古 恬 舍 设 活
峡	挟 夹 侠 狭
恩	嗯 氏 摁 思 蒽
突	吐 图 湥 涂 兔 秃 土 凸 葖 脱
雌	刺 次 慈 呲 佌 此 磁 准
丰	封 凤 峰
麻	林 玛 床 吗 妈 蔴 嫲 嘛 码 痳
C	A G E c S D K T O
浑	混 婚 辉 荤 昏 恽 珲 诨 晖 军
联	莲 连 练 脸 朕
减	退 捡 简 见 键 剪 间 咸 俭 建 坚 渐 減 碱 喊 柬 检
蜜	米 密 蜂 秘
附	府 符 负 傅 复 付 副 腑
紊	文 稳 系 紧 絮
坚	间 奸 竖 尖 兼 见
创	床 感 仓 疮 闯 窗 怆 穿 颅
顶	页 项 頂 盯 订 定 鼎 丁
焦	交 角 蕉 教 礁 胶 较 浇
参	渗 叁 肾 參 伸 惨 申 生 甚 身 深 椮
价	介 家 假 阶 甲 加
毒	都 犊 赌 独 酶 蝳 黩 度 梅 征 霉 堵 染 读 母 菌 杜
率	滤 摔 吕 卒 氯 绿 缕 虑 律
伽	加 甲
银	根 很 硬 垠 龈 茵 人 跟 吟 音 应 引 阴 鹰 印 荫 因 金 影 寅
引	瘾 印 荫 尹 吲 人 银 隐 因 迎 饮 阴 应 蚓 弓
童	瞳 通 同 潼
胯	夸 跨 垮
龈	龄 印 齿 银 跟 垠
桂	贵 圭 硅 挂 归 规
单	丹 惮 弹 掸 但 甲 担
器	奇 齐 期 气 七 嚣 哭 其 弃
靶	把 钯 巴 粑 吧 疤 耙
糠	慷 糖 康
嘴	蟕 觜 啃 咀 角 醉 罪 蕞 最 歪
幽	优 右 油 祐 忧 由
咯	咔 卡 喀 各 可 格 嗝 铬 客 咳
瘩	哒 嗒 疸 塔 大 搭 答 达
火	炎 伙 货 或 灭 活 大
产	浐 铲 厂 畅 缠 长 掺 严 场 常
遗	贵 意 衣 亿 咦 疑 溢 逸 以 胰 移 夷 一 仪 溃 馈 姨 宜
硫	溜 留 流 琉
斜	协 鞋 叙 邪 余 写 卸 谢 懈
尔	而 耳 迩 饵 二 你 儿
啉	林 琳 淋
唾	锤 陀 捶 娷 睡 拓
膈	格 隔 镉 嗝
釉	柚 轴 铀 油 由
路	录 道 卢 潞 部 炉 各 鲁 璐 露 陆
呕	吐 怄 偶 讴 区 妪 欧 殴 沤 鸥
苯	本 泍 笨
氏	式 矢 是 市 氐 克
筋	今 肋 紧 颈 径 荕 晶 近 劲 进 津 胫 经 惊 肌 巾 斤 精 金
腥	猩 醒 星 型 心
氮	啖 谈 旦 氨 胆 但 淡 炎
呃	铬 厄
导	到 道 脲 异 倒
矫	交 校 骄 角 娇 缴 桥 觉 轿 乔 较 胶 绞
代	岱 袋 伐 带 贷 待
叠	置 曡 碟 桑
惧	怖 巨 具 俱
觉	交 叫 角 觅 党 绝 较 搅 见
畏	惟 危 唯 喂 胃 猥 微 委 偎
埋	买 脉 卖 理 薶 迈 唛
固	姑 骨 崮 顾 故 古 估 锢 困
络	洛 骆 落 咯 烙
幻	还 换 焕 幼 患 欢
执	值 质 酯 纨
免	冕 兔 面 娩 勉
燕	彦 言 艳 烟 盐 胭 咽 眼 雁 炎
幼	呦 幻 又 有
撕	撤 斯 嘶
志	痣 质 制 致
说	硕 説 税 朔 化 悦 烁 唆
索	紧 琐 所 精 萦 嗦 脉 锁
叉	查 杈 差 又 岔 插
哺	铺 埔 浦 捕 晡 流 补 甫
弱	溺 若 偌 蒻 性
耳	而 石 茸 洱 饵 二 珥 乳 尔 儿
烫	糖 荡 堂 唐 汤 趟
均	钧 匀
僵	将 江 疆 匠 缰
仿	纺 访 防
源	元 原
檀	擅 谈
图	吐 冬 涂 兔 土 突 头 徒
歪	孬 外 正 嘴 崴
猩	腥 新 星
蒿	篙 高
途	涂 图
洁	节 结
粟	立 栗 宿
窝	蜗 呙 卧 莴 渥 喔 窩 涡 握 我
绀	甘 干 钳
测	恻 厕 侧
丘	求 乒 球 秋 邱 坵 斑
沙	纱 鲨 杀 痧 莎 砂 啥 傻
伐	发 法 罚 乏 阀 代
嚏	体 气 涕 梯 啼 悌
例	里 离 烈 立 利 列 俐 粒 历 哩 力 咧 励
鞭	变 便
华	话 法 化
蛛	珠 朱 株
肘	时 手 寸 州 纣 轴 周 付 村
殖	值 植 直
烯	稀 希
抵	坻 低 底 抗
表	裱 婊 抗
面	体 眠 缅 免 棉 染
指	值 质 趾 直 侄 纸 旨 只 肢 酯 脂
咬	交 尧 校 妖 药 要 幺 姣 姚 狡 吆 喓 较 胶 摇 绞
印	因 荫 阴 卯
切	彻 砌 且 窃 刀 胆 怯 功 伤 劫
贝	倍 北 呗 背 被 钡 备
蚕	蝅 残 蝉 蠺
名	明
升	开 枡 什 生
污	唔 屋 圬 呜 坞 亏
宝	苞 抱 包 寳 莹 保
治	值 知 直 怡 支 枝 辅 志 旨 制 痣 致 冶 之 至 抬 织
锥	椎
干	杆 千 竿 肝 甘 汗 盰 酐
破	容 玻 颇 泼 迫 坡 剖 皮 羊 披
莲	连 恋
修	俢 脩 休 秀
茵	因 荫 菌
烤	铐 拷 考 靠
腾	疼 滕
杞	己 记 芪 纪 屺 枸
休	咻 体 绣 修
褪	退
梁	量 樑 凉 粱
啤	皮 脾
轴	肘 抽 妯 柚 宙 周 洲
绒	容 溶 荣 戎 茸
锌	莘 芯 辛 新 梓 心
砒	枇 批
受	爱 手 售 瘦 守 授 首 收 兽
蜕	退 褪 娧 脱 兑 侻
果	过 裹 菓 棵 馃 粿 蜾
杉	山 衫
赘	熬 坠 缀 锥 獒 贅
泼	拨 波 坡 泊 沷 破
郁	昱 预 予 淤 俞 欲 喻 育 浴 余 遇 有 侑 渝 玉 都 域 鱼 愈 与 御 于 禹
挛	鸾 乱 栾 峦 孪
v	V i w c p y u
开	卡 凯 升
颧	醛 权 灌 泉 權 罐
食	时 矢 湿 是 视 市 石 良 试 实 十 示
梢	稍
转	巴 赚 专 砖 传 移 啭
作	做 坐
叮	盯 订 定 钉 丁
系	希 糸 昔 细 西 奚 息 晞 係 悉
吹	催 炊 垂
咙	龙 胧 泷 拢 隆 聋 陇 㕱 笼
排	非 派 腓 徘 拍 牌 俳 绯
厥	却 崛 蕨 阙 撅 绝 噘
链	莲 球 涟 琏 连 练
豆	都 逗 斗 窦 抖 痘
枕	孑 针 酖 沈 昣 忱 政 帧 诊 钦 桢 珍 真 耽 阵
杂	扎 咋 砸
农	脓 浓 侬
甘	苷 泔 柑 杆 干 咁
颜	彦 言 盐
穿	瑏 传 川 疮 串
苹	平 评 萍
滴	抵 底 嘀 摘 地 帝 弟 低 第
律	滤 箻 率 氯 绿 葎 性 虑 津
汁	治 什 支 计 十 之 针
砂	莎 沙 纱
罗	啰 逻 洛 箩 椤 络 落 锣 萝
月	钥 越 悦 玥 曰 云 目 姨 日
壶	弧
绿	录 路 滤 吕 率 碌 屎 氯 缕 虑 律
胺	铵 安 氨 按
影	婴 境 樱 硬 印 颖 银 应 映 隐 引 英 隠 脏 景 瀛 瘿
拉	剌 垃 啦
盲	茫 忙 芒 育
缬	撷 榭 携 写 颉 斜
狼	浪 狠 粮 郎
瞳	童 通 曈 铜 僮 同 潼
灼	钓 汋 桌 炽 酌 捉 勺 卓 啄 着 浊
调	蜩 吊 强 雕 周 挑 凋 跳 条 眺 倜
疑	凝 易
褐	鞨 揭 鹖 喝 和 渴 禾 鹤 贺 竭 赫 盒 嗬 曷
匀	孕
护	乎 户 沪 胡
衣	依 以 一
腐	府 符 浮 复 付 副 甫 伏
骤	取 聚 周 皱 揍
锐	睿 税 悦 鋭 兑 瑞
铂	伯 袙 泊 白
翻	泛 幡 反 饭 蕃 返 番
丁	亇 盯 叮 订 汀 定 T 顶
螃	磅 旁 鳑 滂
木	本 墓 术 牧 母 沐 目
藿	霍 嚯 或
烟	盐 因 焰 咽 胭 晏 研
造	噪 早 告 慥 诰 迢 适 遭 澡 吿 照 燥 灶 心 皂
葱	从 聪 怱 惚 匆 忽 囱
假	价 葭 架 家 钾 遐 甲 瑕 加 暇
柏	栢 迫 泊 白 佰 百
厌	言 烟 犬 胭 验 咽 严 宴 雁 庆 炎
暗	谙 黯 案 按
崴	外 歪 威
锰	孟 猛
值	指 直 之 植 殖
蝶	爹 碟 叠
模	莫 摸 膜
苦	库 若 哭 酷 古 枯 楛
盘	袢 潘 孟 盤 锥 盆 磐 判
扶	服 夫
莓	酶 每 没 梅 霉
碱	捡 建 减 见 咸 检 喊
唐	瑭 糖 塘 溏 汤
软	軟 暖 吹 欣 脚 阮 挛 轶 管 朊 钦 欠 轻
黛	带 袋 代
醇	松 淳 纯
潜	浅 血 前 钱 迁 替
载	裁 栽
方	芳 仿 房 万 放 肪 纺 防
疥	疖 节 介 芥 阶 结
背	倍 北 呗 脊 蓓 被 辈 备
羟	氢 腔 羫 强 经 轻
花	话 椛 红 化 华
狂	枉 汪 旷 诳 矿 王 狅 框 邝
呼	虎 胡 窘 乎 忽 吁 咕 护 付
笼	聋 龙
芦	庐 卢 炉
噎	壹 也 夜 耶
速	述 诉 素 俗 束 愫 酥 宿 塑 涑
铃	玲 领 伶 零
沉	臣 沈 忱 尘 陈 冗 成 承 晨 辰
误	物 吴 蜈
柠	宁 拧
淡	啖 谈 旦 氮 但 单 炎
歇	些 蝎
晚	婉 碗 免 挽 甲 娩 上 皖 玩 完
筛	塞 簁 晒 帅 师 狮 篩
那	呐 纳 哪 娜
梦	蒙 林 孟 萌 楚 懵 猛 盟 多
醛	铨 荃 痊 诠 全
猕	弥 妳
虹	红
冷	楞 玲 棱 今 怜 令 铃 凉 凌 唥 泠 伶 愣
孤	姑 股 呱 箛 狐 古 瓜 估
牡	壮 杜
忧	优 尤
粗	猝 会 殂 糙 出 组 柤 醋 租 促
祛	却 去 取 袪
射	摄 蛇 榭 形 社 色 舍 谢 设
粒	里 离 泣 立 栗 利 拉 例 力 棵 李 笠 柆
填	塡 镇 充 舔 慎 添 天
粉	份 芬 酚 分 汾 枌
毛	芼 卯 矛 冒 帽 猫 茅 牦
提	体 缇 踢 题
迷	秘 泌 谜 密 米 眯 咪
耻	指 趾 扯 址 齿 祉 止 尺 吃
团	湍 困
颞	聂 捏 镊
芒	亡 茫 盲 忙
穴	学 血 峃 泬 茓 谑 雪 八
虱	式 湿 鲺 施 虫 食 师 狮 失
限	陷 先 现 线 显
普	铺 噗 浦 晋 谱
鲜	不 先 限 现 线 仙 显 藓 贤 廯
巧	窍 乔
糕	高 羔 膏
摔	率 甩 蟀 帅
踩	菜 婇 彩
莫	末 漠 膜 摸 模
咸	减 闲 鲜 显 贤
沫	馍 末 墨 抹
孟	蒙 梦 盂 猛 于
停	挺 听 亭 婷 廷
渣	榨 喳 查 炸 碴 楂 揸 扎
布	不 步 部 怖
超	吵 朝 抄 巢 招 迢 钞 潮 维 起 操 嘲 绍 怊 赵 炒 巣
酰	宪 腺 先
趾	指 跖 址 祉 止 只 肢 脂
眦	滋 呲 此
困	捆 坤 梱 闲 因 悃
语	唔 宇 与 于 予 禹 悟
听	挺 析 昕 汀 近 庁 停 厅 斤
仁	壬 任 认 人
十	1 ＋ 时 石
壁	避 币 弊 臂 劈 毕 璧 闭 庇 比
红	哄 荭 疼 工 花 江 虹 弘 洪 宏 冯 烘
菇	姑 故 骨 古
元	源 远 院 原 芫 无 园 沅
差	搓 羞 查
贵	柜 遗
拇	木 姆 母 目 大
苏	芳 速 素 俗 酥
癖	屁 避 辟 僻 劈
远	运 元 院 源
嗡	翁
织	只 炽 治 枳
催	摧 崔 倕
过	過 寸 果 菓 国 郭 讨 村
尽	劲 进 精 烬
辅	辐 哺 铺 傅 治 腐 幅 蒲 捕 复 付 副 甫 输
丸	纨 弯 九 万 力 宛 挽 玩 完
坠	队 追 咀 尘 缀 赘 锥 堕 椎 贅 墜 最
茯	伏 付
倍	陪 呗 卡 蓓 涪 被 贝 备
囟	信 辛 卤 卢 凶 囱 心
做	作 坐
抽	怞 牰 扭 愁 稠 袖 紬 柚 丑 踌 轴 筹 瞅 油 仇 由 酬
言	烟 颜 盐 严 炎
憩	妻 气 汽 欺 稽 稀 其 器 息 窒
玉	钰 王 与 宇
抬	台 太 胎 苔 拾
堂	糖 膛 唐
椒	交 角 淑 蕉 娇 脚 蛟 叔 胶
新	莘 信 辛 薪 欣 锌 心
脲	尿
吓	下
活	洁 火 话 伙 或 沽 霍
醋	酸 酒 措 酷 惜 酢 粗 促 错
额	颚 鳄 俄 呃 萼 恶 耳 饿 鹅 莪 谔 蛾 颌 額 客 鄂 儿
净	挣 敬 京 径 精 劲 境 静
情	青 清 请 晴
伤	尚 殇 仂 骨 觞 损 饬 垧 上 商
安	胺 氨 按
立	里 丽 利 拉 力 粒 历
苗	描 庙 妙 秒 瞄 喵 田
犬	劝 畎 打 权 泉 太 全 吠 伏 大
痤	坐 戳 痔 唑 锉 挫 座 错
铬	咯 各
温	文 湿 稳 瘟 问 揾 搵 愠 缊 蕴 瑥
诱	有 右
牛	柳 妞 生 纽 汼 午
土	吐 图 士
扩	阔 广 圹 廓 括 拓
扯	彻 址 止 尺 撤
伏	优 符 扶 肤 犬 浮 服 付 夫
莱	来
蚬	见
镁	美
痨	唠 劳 捞
黑	嘿 投 墨 黒
米	三 迷 秘 密 眯 咪
泥	呢 尼 妮
着	著 这 捉 酌 看 照 卓 者 找 睡
锅	呙 郭 埚
P	V t q R p Q B O
蟹	歇 屑 泄 写 蝎 卸 泻 谢 解
热	熟 焼 惹 势 执 虚 烫 喏 熱 浇 夜
报	鲍 保 抱
蛀	柱 主 驻 注 住
拍	牌 怕 排
处	外 出 触
洱	饵 而 耳
齐	奇 济 起 脐 其 挤
留	榴 瘤 六 刘 流 溜
物	伍 无 勿 五 雾 匆 戊 吴 误 武 务 舞
跑	袍 炮 泡
榴	溜 留 硫
块	快 诀 决
老	佬 考 姥
析	希 吸 洗 柝 系 晰 折 汐 惜 稀 忻 西 息 淅
冲	虫 沖 充 仲
n	t m o h N
伊	依 衣 尹 已 一
芋	于 渔 竽
巢	朝 抄 超 潮 果 曹 剿 菓 嘲 槽 巣
忆	亿 咦 以 仪 一 亦 性
还	环 海 怀
噜	卢 路 鲁 露 撸
D	d E B 第 P O
i	a 艾 l v e
强	枪 腔 墙 抢 镪 调 羟
轻	晴 请 氢 清 经 青 靑
钛	态 太 肽
胡	糊 葫 乎 湖
放	方 芳 房 仿 适 纺 防
蜘	知
三	叁 伞 叄 山 3 二 散 米 仨 彡
尺	迟 齿 耻 吃
宣	轩 喧
藕	偶 耦
埃	哎 挨 唉 艾
馒	慢 漫
夜	掖 叶 页 业 液 腋 也 烨
B	β b D P 比
行	荇 形 刑 姓 性 型
换	还 环 唤 焕 涣
顺	舜 瞬 橓 順
摇	遥 药 瑶
保	堡 煲 报 抱 宝 包 葆 饱
姨	意 夷 宜 咦
秃	涂 图 兔 凸 突
汤	饧 糖 荡 堂 烫 唐 场
长	场 肠 涨 尝 帐 张 账 掌 常 胀
鱼	雨 宇 玉 余 熏 于 亩 渔 与
早	噪 造 皁 枣 遭 澡 藻 旱 草 糟 皂
蛇	沱 射 舌 它 舍 设
疲	啤 皮 脾 披
愤	忿 偾
合	和 禾 颌 盒 核
波	拨 玻 播 泼 勃 博 搏 坡 啵 跛 皮
科	珂 壳 料 柯 刻 可 轲 克 课 颗 枓 抖 棵 蝌 客
光	逛 咣 滞 广 胱 洸
粑	把 吧 巴
窗	床 创
F	P E
谢	榭 泄 写 泻 些
横	恒 橫 哼 黄
针	汁 挣 镇 争 帧 什 贞 诊 珍 抖 真 枕 阵
忌	济
掉	吊 钓 焯 雕 卓 铞 调 凋
围	唯 韦 维 伟 未 卫 味 微 违 为 偎
相	项 向 湘 想 像 目
眉	酶 每 媚 没 梅 霉
颗	髁 科 可 粒 刻 棵 克 课
前	浅 千 潜 脚 怀 签 钱 偂
尖	捡 建 监 间 奸 兼 见
慕	墓 幕
哭	嚣 苦 库 㕦 器 枯 楛 骷
辐	副 复 幅 福
防	方 芳 访 仿 房 妨 坊 昉 放 肪 纺 狂
宁	林 拧 灵 宇 咛 凝 柠 泞
稀	希 析 吸 洗 系 桸 浠 汐 悉 西 烯 晞
痧	莎 沙 砂 纱
膏	糕 槁 育 羔 诊 睾 高 药 搞 髙
危	唯 威 位 微 诡 委 为
池	驰 吃
色	瑟 铯 塞 绿 绝 涩
喝	和 褐 渴 禾 盒 竭 合
躺	趟 尚 淌
迹	既 即
芎	汹 弓 穷
丛	从
岔	茬 差 叉 查
易	意 咦 异 义 以 忆 已 翌 皮 一 剔
O	0 哦 C o D Q
雕	凋
旁	胖 庞 膀 磅 滂 徬 螃
鹅	峨 俄 额 蛾 饿 娥 儿
R	A P r B T
小	发 校 下 晓 肖 销 孝 笑 坨 少
斤	近 今
重	从 踵 中 种 充 虫 喠 锺 憧 冲 众 仲
麦	素 买 脉 卖 迈 唛
紧	仅 紫 尽 今 颈 井 近 金 进 锦
墨	末 黑 默 摸 模 磨
油	有 抽 柚 铀 邮 由
总	中 纵 宗 综
堵	都 赌 诸 睹 度 者 带 读 杜
晴	镜 靖 睛 精
透	秀 投 绣 头 骰
至	治
爬	趴
撸	鲁
罩	兆 照 卓 召
A	G C a 啊 S R H I s
胛	响 钾 甲
徘	排
槽	曹 糟
瓷	姿 次 齿 茨 词 此 磁 咨
界	介 节 街
晶	金 睛 精
龄	玲 零 领 铃 凌 伶 翎 岭
除	涂 滁 触 出 余 处 初 赊 锄 杵 蜍 雏 囊
闪	闲 山
圣	剩 苼
抓	爪
香	乡 相 杳 向 箱 享 查 想
e	额 a E c r o
时	是 候 石 诗 莳
喂	唯 谓 猥 畏 为
何	荷 河 和
嗨	海
役	疫
尼	拟 泥 你 呢 伲 妮
谱	浦 潽 普
慰	蔚 为
M	S m N
伸	肾 砷 婶 绅 申 甚 神 身
h	H j n
缩	羧 琐 所 嗦 宿 宫 锁 唆 梭 摍 索
I	1 V L i l T
秒	描 杪 苗 妙 喵 纱 砂
V	Y W U I P
标	飚 標 杯 表 彪 示
隙	僚 细 西 系
m	c M n
鸭	呀 押 压 鸦 丫 哑 亚
移	依 亿 宜 咦 异 椅 义 侈 以 栘 佚 肝 结 一 易 乙 姨 多
通	痛 酮 桶 筒 捅 鼻 同 彤
哆	多
骶	柢 底 邸 纸 骷 低 呧 抵
撒	洒 潵 散 撇
渗	槮 参 慎 深 椮
戴	待 代 袋 带
闹	恼 劳 捞 佬 脑
坏	环 杯 抔 怀
冬	动 东 咚 冻
瓜	挂 呱 果 刮 苽 爪
陈	趁 辰 晨 沉 阵
回	声 会 茴 结
效	校 肖
饭	范 反 畈 饮 返
垫	热 电 店 点 典
不	发 丕 气 哺 木 育 化 部 鲜 布 步 捕 卟 着 补 卜
漫	慢 曼
噩	饿 蛾 额 恶
茄	切 加 伽 且
凝	拧 疑 柠 狞 宁
阵	针 镇 震 政 陈 证 珍 真 振
双	霜 叒 爽 头 又
动	冬 攻 东 冻 部 洞 劲 经 栋 碍 玏
致	治 志 至 纸
运	晕 孕 芸 神 云
痱	菲 非 腓 沸 绯
丹	舟 旦 玬 但 单 担
旺	王 汪 枉 往
锋	峰
梨	离 犁 利 例 俐 粒 黎
因	姻 银 音 应 引 英 阴 囚 茵
芥	介
秧	央
基	鸡 机 剂 积 其 肌 急
蒜	算 酸 祘
仪	义 以
挺	廷
儿	而 耳 几 二 尔
浇	烧
疖	孑 疥 节 介 芥 叩 痞
稽	嵇 及 耆 激
烦	页 藩 反 帆 饭 凡
匿	泥 膩 若 昵 你 逆
济	齐 剂 挤 及
饮	次 吹 印 因 引 钦 㳄 欠 龈 软
牵	千 签 钱 宰 迁 欠
解	槲 接 节 姐 檞 借 结 捷 斛 懈
窘	急 囧
驼	坨 拖 托 陀
上	尚 下 晚 土 伤
肉	内 禸 柔 揉 又 媃
棕	总 综 宗
妻	齐 七
哼	亨 恒
草	曹 早 卓 操
赶	杆
容	溶 蓉 榕 客 破
魔	莫 摩
浮	孵 扶 负 孚 附 复 服 腹 俯 俘 夫 伏
酿	娘
漓	离
楂	渣 扎 查
膛	堂 樘
乌	邬 物 呜 吴 鸟 无
塑	朔 溯
餐	惨 参
螨	漫 满
憋	别 瘪 蹩 弊 鳖
醒	猩 省 姓 性 惺 星 腥 行
钼	泪 目
枝	吱 肢 支
陷	掐 馅 限 现 线 险
糊	蝴 胡 湖
全	铨 荃 劝 育 权 仝 泉 拳 痊 金 圈 佺 券
床	木 断 疮 闯 窗 怆 创 庆 幢
弛	持 张 驰 池
煎	剪
泪	类 钼 汨 累 汩 目
点	颠 电 碘 店 典
蓖	弊 璧 媲
去	取 驱 祛 屈
取	娶 去 区
镰	廉
慧	会 惠
绝	觉 色 蕨 决 撅
漉	鹿
挣	睁 争
咧	例
金	今 凎 京 淦 惍 精 近 经 惊 琻 全 进 巾 津 斤
痹	毘 必 弊 蔽 壁 病 毙 闭 庇 畀 鄙 笔 比
盆	孟 骨 盘 棚 湓 分 贫 盒 喷 葐
托	妥 拖 脱 坨 拓
瞌	磕 刻 棵 课 嗑
硅	桂
但	担 胆
遍	偏
冻	冬 东 动 洞 栋
糙	曹 造 嘈 操
浅	前 千 潜 线 钱
乎	胡 呼
卧	捾 握 沃 我 窝
预	欲 育 玉 与 予 俞
无	勿 芜 兀 五 屋 物 吴 天 武 元 吾
磕	嗑 克 咳 瞌
眨	咋 乏 泛 姂 频 炸 扎
蕉	焦 姣 较 礁 浇
整	挣 正 诊 拯 征 证
依	衣 以 一 仪 伊 倚
稍	烧 哨 少
爆	曝 胞 暴 瀑
聚	巨 句 据 取 具
尾	韦 股 伟 胃 未 位 维 畏 委 为 围 娓
灶	造 早 坛 社 澡 土 兆 燥 糟 杜
构	够 勾 购 钩 沟
逍	消 销 肖
入	如 人
锯	居 巨 据
萘	奈 盐
痢	莉 利 俐 力 哩 梨
玄	炫 悬
钢	杠 纲 岗 刚
菜	莱 才 采 蔡 踩 彩
禁	尽 竟 紧 颈 浸 近 劲 襟 进
猪	诸 朱 潴 主 住 祝 煮 猎
兔	土 图 免
驴	氯 吕
煤	酶 谋 媒 没 霉
拥	用 涌 佣
归	贵 圭 龟 硅 鬼 规
疽	蛆 且 据 拘 具 阻 狙 痈
益	意 医 亿 溢 义 以 抑 一 易 宜
枣	早 澡 栆 皂
须	絮 续 许 需
刨	袍 疱 剖 跑 抛
杀	纱 啥 莎
鲍	包 饱 胞 抱
琥	唬 虎
硒	茜 西
距	巨 矩 据 拒 具
封	缝 崶 风 逢 凤 丰
碘	颠 店 殿 点 典
注	柱 主 驻 流 住
空	孔 控
曼	慢 漫 缦 蔓
垢	够 勾 后 钩 诟
蒸	争 正 烝 拯 整
擦	攃 察 嚓
搂	瘘
杠	缸 肛
铵	胺 按 安
机	鸡 及 积 几 肌 激 级
棘	髻 刺 及 几 疾
嘌	票 漂 飘
纳	钠 吶 内 讷 那 呐
纯	莼 春 吨 醇 淳
初	除 出
晃	慌 幌 皇 恍
妥	绥 托 陀 脱
蝗	皇
骺	垢 后 骼
雄	凶 匈 雌 熊
蓝	监 澜 兰 栏 篮
派	哌
的	时 得 地
种	中 祌 钟 肿 仲
顽	烦 玩 完
本	苯 木 笨
肓	忙
旗	期 其 骑 施
斗	都 抖
藤	腾 滕
奇	齐 琪 汽 琦 其 骑
宗	综 棕
首	手 守
盐	言 监 烟 淹 胭 咽 特 严 眼 研 岩 炎
泰	酞 秦 台 太 溙
工	公 宫 共 功
观	官 关
橘	句 据 桔 菊 局
蹄	提 踢 帝 梯 啼 剃
荔	丽 利 力 粒 李
洋	样 扬 阳 羊 杨
材	才 高
里	立 厘 利 粒 哩 历 李 理
北	倍 背
哑	亚 呀
灵	玲 零 林 令 铃
向	相 项 响 冋 像
昔	夕 惜 西 硒 悉
迁	千
藏	臧 缄 脏 赃
蛹	用 涌
霖	林
典	碘 点
堡	保
位	惟 唯 立 拉 伟 未 卫 味 微 伪 为 围
竹	朱 柱 住 珠 株
鳝	善 缮
麝	佘 摄 射 奢
斯	嘶 司 思 四 撕
脘	完
桡	挠 跷 绕 饶
余	于 与 鱼
荞	乔 俏 桥
庆	清 厌
番	藩 翻 蕃 幡
灌	罐 贯 惯 管
拭	试 式
壮	妆 状 撞 装
嚼	较 爵
斛	斗 狐 角 湖
锻	煅 段
芍	勺
少	烧 哨 稍 小
末	莫 模 抹 未
第	弟 地 底 滴
跤	交 较 胶
奈	爱 耐 余 萘 乃
皱	绉 轴 皮 周 咒 驺 诌 邹
断	床 段
椰	耶
陀	坨 沱
鹉	鹅 武
奥	澳 傲
薄	博 搏 蒲 谱 饱
辟	僻
枯	苦 库 古 楛 骷
伦	仑 论
荑	咦
裹	蜾 果
练	量 炼 联 链 连
棉	面 眠 綿 绵
骼	嗝 咯 各 格
轮	仑 抡 论 伦
饱	胞 抱 包 孢 鲍
交	跤 角 教 蛟 较 胶 绞
呛	枪 仓 抢 苍 羌 炝
皲	军
钴	股 估 姑 古
盂	孟 余 盆 于 与
照	昭 招 召 找
弓	拱 躬 工 公 引 宫 共
帆	凡
组	诅 阻 租 足 祖
漏	娄 喽 瘘 楼 露 屚
主	拄 猪 注 住 王
蔬	疏
监	临 槛 捡 建 间 兼 检
击	及 机 吉
藓	廯 癣 鲜
蛔	茴 回
霍	嚯 火 豁 瞿 藿
吉	及 机
璃	离
忘	网 望 妄
蛲	晓 挠 饶 绕 脑
泛	乏 范 柉 饭 返
匮	贵 溃 亏 馈
杨	样 扬 洋 炀 羊
桔	洁 据 橘 菊 吉 枸
痪	唤 焕 换
肽	胎 钛 太
蝴	湖
蒙	朦 檬 萌 濛 猛 懵
椿	春
可	珂 刻 克 孕 微 柯
乐	洛 了 勒 牙 妇
樟	章 障
蔗	遮 庶 嗻
熏	醺 薰 寻
癀	黄
葵	揆 奎 魁 亏 睽
崩	甭 泵 嘣 绷 蹦
鲫	骥 即 机
薯	数 暑 属 署 书
缘	椽 源 橼 远 掾 原 元
喹	奎
炼	练
旋	漩 泫 悬 施 选 旅 璇 炫 玄
福	副 服 弗
繁	返 睛
犀	溪
淀	电 殿 碘 店 定 滇
窍	窃 巧
士	土 氏 仕
集	及 急 级
径	茎 劲 经 胫
娩	晚 挽 免 勉
零	令 0
虫	崇 茧 充 重 蟲 冲 痋 翀
铠	恺
暴	曝 报 爆
卡	倍 掐 咔 卞 咯 片
辰	娠
浓	侬 脓 农
哈	呵 合 蛤
挡	档
朗	郎 浪 郞
钝	炖 吨 纯 顿
族	旅 镞 组
党	当 觉
睁	铮 挣 争
甾	淄 灾
咕	姑 股 故 呱 古 估
举	榉
芹	秦 芩 钦 情 琴 沁 斤
膦	麟 鳞 磷
浦	捕
荷	何 和
虎	唬 虑 护
茸	容 耳 荣
岛	导 鸟 道 到
梭	俊 羧 缩 锁 唆 索
衡	横 橫 蘅 恒
钩	购 沟 构 勾
营	官 赢 应 宫 菅 影 莹
熟	淑 孰 数 暑 属 首 署 书 输
义	一 异 仪 易
忿	贫
咀	组
炖	钝 吨 饨 纯 顿
厕	测 侧
趴	扒 爬 啪
榔	郎 郞 朗
汉	旱 含 汗
酊	钉 丁
鞍	胺 铵 安 按
恢	灰
谵	詹 蟾
狗	够 勾 苟 购 钩 沟 枸
樱	婴 英 应 缨
N	A M m H
豌	腕 碗 玩 婉
瑰	鬼 硅
蹬	登 瞪
撞	僮 憧 装 壮 幢
顿	钝 吨 盾
揉	柔 糅 媃
打	咑 大 找 答 达
怕	伯 帕 拍 白
惊	警 晶 镜 京 径 凉 精 障 掠 经 谅
久	旧 灸 九 玖
用	咏 甩 拥 痒
蒂	荻 第 帝
酗	虛
鲁	噜 卢 撸
吗	马 码 玛 嘛
连	莲 联 链 涟 练 脸 阵
裤	库
港	刚
局	焗 居
秦	嗪
库	裤
偻	缕 楼 篓 娄
癔	意 噫
象	向 像 相
境	镜 景
噪	躁 澡 燥
呆	待 目 代
剑	间 捡 检
婚	昏 混
写	泻
塔	塌 嗒
搁	阁
玛	马 码 吗
格	隔 各 个 咯 嗝 铬
膳	善
吡	比 批
贾	假 甲
洞	硐 东 冻 动 侗 垌 同 炯 栋 泂
屏	平 瓶 塀 坪 屛 并
爱	哎 唉 艾 嗳 哀 受
倾	晴 顷
吃	迟 齿 痴 持 尺 哧
姿	资
式	氏 是 市 试 似 武
佐	左 咗
芩	今 芹 令 金 琴
碍	爱 哎 癌 隘 蔼 动 恐 锝 埃 嗌 挨 堨
厄	恶 呃
秋	球
太	钛 肽 台 态 犬 泰 抬 大
区	曲 去 取 躯 驱 枢
见	柬 现 剑 建
蒄	冠
鼠	癙 术 属
朴	补 卜
杜	度 社 肚 赌
拮	结
苁	从 丛
自	字 白 子 孜 目
剥	拨 博 波 薄
拿	纳 衲 那 捺 呐
残	浅 惨 殊 参
擤	鼻 醒
铜	桐 同
庞	厐 尤 滂
独	笃 杜
扑	仆 铺 朴 补 卜
禹	龋
京	近
铝	铅 吕
t	d a i c l n s T 替
S	5 $ C c M s
漂	瞟 嫖 飘 票
片	斥 魸 卡 偏 篇 骗
袢	拌
畅	唱 敞 长 肠 杨 场 常
椮	参
丝	死 司 斯 思 咝 四 撕
乏	发 法 泛 伐 之
柚	铀 油 由 袖
冰	水 病 柄 宾 丙 饼 泳 氷 兵 并
拜	掰 白 柏
搔	骚 瘙
遂	隋 随
茅	予 矛 毛
濞	鼻
啶	定 锭
窄	搾 宅
蚴	呦 幼
葚	渗 椹 甚
夹	颊 侠 架 假 荚 甲 加
硼	鹏 棚 朋
溪	西 奚
茧	减 萤 捡 建 俭 笺 虫
充	填 冲 铳
荟	会
和	禾 合 核 何
噻	塞 赛
啡	非 上 菲 绯
橼	元 缘
鉴	捡 简 见 坚 箭 检
瘾	银 隐
柄	病 炳
汽	气
叛	泮 判
镶	襄
恒	亘 横 桓 哼 姮
宽	曲 款 髋
裆	当 档
蟾	蛤 詹
蜍	蟆 除
扫	嫂 埽 掃
皿	血
锑	剃 悌 弟 梯
舟	周 侜
痕	拫 很 恒 印 横 般 狠 恨
矽	汐 夕
炔	缺 决
榨	窄 咋 炸
洗	希 吸 冼 先 系 铣 喜 汐 稀 西 溪
分	份 芬 粉 酚
霜	酸 爽 双 灀 孀
芝	质 指 乏 支 之
亭	停
窿	隆 癃
禽	秦 离 亲 擒 群 沁
喃	南 楠
挂	桂 卦
熊	凶 匈 能
惫	备
英	央 音 应
伲	尼
培	倍 涪 陪
匹	皮 脾 -
描	喵 苗 瞄
延	研 廷 严 盐
L	I k
峰	锋 风 疯 烽 蜂
溴	嗅 休 修 臭
颠	癫 殿
砷	伸 申 神
天	开 填 添 夫 无 夭 田
施	是 诗 拖 士
浸	进 侵 津
涵	含
蝉	婵 铲 单 禅
返	反 饭
苓	令 零 铃 玲
葆	保
思	斯 司 撕
炉	卢 芦
盗	稻 道
当	档 党 挡
南	喃 男 兰 楠 难
伟	委 韦 伪
刚	钢
呈	成 橙 程
踏	蹋 沓 塔 塌
妮	尼
含	函 今 旱 涵 晗 汗
玫	每 玖 没 莓 枚
+	十
会	汇 变 绘 回 荟
赤	斥 迟 尺 哧 吃
有	右 铀 味 又 由
楞	愣
氢	氰 请 清 氧 青 轻
截	洁 接 节 竭 结 劫 捷
姆	拇 母
泮	袢 潘 畔 胖 盘 伴 半
戒	界 诫 绒 借
意	益 义 薏 易
粮	浪
美	每 镁 没 梅 莓 姜
榧	匪
汞	贡
鸽	各 佮 咯 格 铬 歌
持	池 侍
年	黏 哖 念 粘 娘
馕	囊
公	功 宫 共 工
替	体 提 题 梯 剃 剔
实	时 湿 试 突 尸
翼	意 羿 羽 咦 溢 糞 易 译
窥	规 亏
稳	急 吻 玟 温
循	寻 盾 殉
知	值 和 治 智 支 枝 只 之
渊	元 远 苑 源
字	自 子
成	呈 城 戍 承 程
寄	即 机 剂 济 季 计 几 倚
记	己 及 继 计 纪
适	湿 是 石 恰 试 放
炭	坛 碳
必	毕 铋 比 泌
网	王 往
非	婓 菲 匪 飞 腓 啡 绯 费 肺
润	闰
晨	辰 沉 陈
辛	莘 芯 幸 欣 新 锌 心
茱	朱
促	趗 猝 醋 粗 足
默	末 模
槟	宾 滨 膑 兵
γ	y
革	隔 各 咯 格 戈
灰	毁 荟 恢 辉
躯	驱 区
掏	陶 淘
夏	下 厦
拳	誊
β	B
θ	O
棒	帮 邦 榜 蚌 捧
泽	则 择
绦	涛 条 洮
辨	辩
话	化 华 活 話
加	佳 伽 夹 迦 家 甲
朊	阮
熬	敖 傲
来	莱 扭
挤	齐 剂 济 脐 基
完	万 玩
坑	阬 抗 炕 吭
离	里 历 理 梨 璃
是	示 屎 事
咪	米 迷 眯
音	喑 因 愔 阴 龈
俞	榆 瑜 愈
扇	善 陕 山
很	狠 银 跟 恨
妈	码 吗
响	饷 相 胛 向 想 晌
揪	就 啾
迎	应 映
靠	考
龅	抱 包 暴 孢 鲍
喜	希 系
绷	棚 崩 朋 蹦
劲	尽 竟 敬 颈 径 经 进 静
灯	等 登
杏	木 杳 幸 星 型 兴
险	检 县 捡 线
旧	久 就 九 日
察	查
付	副
扰	优 饶 忧 绕 桡
蛰	蜇 哲
恍	慌 光 晃
剪	煎 减 捡 见
孑	子
七	奇 齐 期 其 柒
夫	氟 扶
栗	粟 立 俐 粒 力
茬	碴
g	d G j q
竖	速 数 坚
脯	铺 浦 辅
卞	下
嵌	前 潜 钳 偂 欠
先	宪 酰 鲜 线 险
腊	辣 蜡 啦
母	木 毋 亩 姆 拇 目
鹌	安 庵 奄 按
鹑	醇 淳 享
亏	溃 夸 奎
燎	撩 缭
佟	疼
俯	府 付
逃	桃
绕	饶 浇
嵴	脊
芨	岌
嗐	瞎
班	斑
犮	发
馨	欣 声 薪
博	波 搏 薄
陶	掏 淘
涎	诞 延 旦
件	捡 键 见
佝	勾 苟 狗 岣 钩 枸
耶	椰
衍	行
拓	石 托
星	形 芯 猩 睲 新 醒 性 惺 腥 行 型 兴
陆	路
锂	里
猴	候 喉 侯
芷	止
痦	唔 悟 五
笋	隼 尹 孙 损
妄	亡 罔 忘 王
田	填 天 钿
刀	到 道 刃 叨 力 导
弹	肩 谈 掸
萸	庾
锈	铁 绣 秀
虾	吓 瞎 下 峡
苑	怨
养	样 扬 佯 氧 洋 羊 杨 痒
卑	碑
束	树 速 术 数 柬
海	嗨 梅 每 害
仙	汕 山 先 鲜
得	的 徳 德 嘚
占	站 古
恋	怒 连
九	久 就 旧 丸
挠	恼 劳 绕 浇 唠
胁	累 协
焕	换
嘿	黑
卟	补 卜 朴
怒	努 奴
望	往
芸	云
伯	佰 泊
蚂	马 吗
桑	嗓 搡 丧 槡
蘑	磨 魔
腌	掩 颜 淹
雪	鳕 学 血
步	不 涉 布
边	笾 变 编 便 遍
难	難 摊 堆 南 男 滩 楠
帽	贸 冒
历	力
而	二
一	亦 亿
覆	复 腹
递	第
H	N h
焊	稈 汉 旱 悍 汗
嘟	都
轨	诡
跌	迭 爹 昳
抛	刨
枪	呛 抢
挑	桃 跳 实 眺
遮	蔗
两	量 俩
凹	嗷 凸 坳 奥
饥	机 几 肌
佩	珮
短	端 段 断
厉	历
仓	藏 苍 怆
岁	随
伴	半 班 拌
念	年 粘
职	只 值
次	刺 茨 此
谷	固 股 故 古 估
抱	包 胞
层	曾
台	胎 抬 苔
沥	力 历 里
抹	末 沫
到	道 倒
厘	里 李
住	往 主 柱 助 注
悬	旋 炫 玄
橙	成 澄
栀	质 芝 枝 栉 枳 至
沐	木
侵	亲 沁 浸
剧	疼 据 具 居 锯
嚢	囊
壳	克 咳 壶 可
砸	咋 杂 咂
千	仟 钎 迁 干
裸	棵 蜾 骡 踝
摘	嫡 窄 宅
辣	刺 啦 瘌 拉 垃 敕 喇
杭	忼
嫩	嫰 恁 潄
没	酶 每 殁 梅 投
东	懂 冬 咚 冻 栋
编	偏
烈	痛 列 裂
插	擦 查
鬓	斌 膑
弯	湾 玩
特	侍 忑 矮 殊 忒 萘 待
比	吡 芬 笔 庇
枫	风
车	伡 扯
春	椿 纯 蠢
暖	煖 媛 缓 嗳
明	铭 朋 眀 名
飞	非 腓 肥
咦	遗
严	炎
救	就 求
茉	抹
较	叫 绞
学	字 血 峃 雪 穴
础	除
军	君 皲 均
淮	惟 锥 槐 推 准
炒	抄 吵 超 钞 妙
笑	孝 肖
戈	各
勒	嘞 乐
蕊	瑞
每	梅
犯	泛 饭 范 氾
四	泗 私 驷 西 思 彩
鱿	铀 尤 优 鲉
T	体 F t C L p 丁 I
菖	昌
走	驺 奏 赴
宜	且
朋	盆 友
Ⅳ	死
唧	即 叽
璜	磺
胬	怒 肉 驽 奴
蕃	番
肼	进 井
舍	蛇 舌 社 猞 舎
贮	驻
枷	加
岩	言 眼
疔	厅 丁
羚	玲 领 铃
恐	崆 孔 箜 空 巩 碍 控
套	掏 桃 逃
豇	江
捂	唔 梧
迪	笛 地 第 递 蒂
疳	苷 甘 柑
糯	懦 檽 烙
钻	站 鉆 粘
蚝	好 耗 豪
雷	镭 类 雨 勒 蕾
丽	力 里 俪
糟	遭 槽
踮	掂 店 点
钉	订 顶 丁
臼	桕 旧 曰 揪
絮	续 绪
耗	牦 蚝
楔	锲 械 契 斜
萨	卅
事	世
兜	皃
偿	唱 长 常 尝
卓	桌
蓉	容
考	拷 烤 靠
钱	践 前 线
捏	涅
腙	踪
菲	非
藜	黎
文	纹 炆 温 问
旨	指
漠	莫 模
幕	幂 慕
钡	贝 呗 备
吞	屯 脱
助	主 驻 祖 住 祝 疗
9	久 6 q
仲	中 种 肿
柯	轲 克 珂 可
漾	洋 羊
碧	币 壁
待	带 侍 代
采	才 踩 彩 菜
匍	葡
扣	口
祺	琪 其
塘	唐 糖
梳	书
婷	亭 听 停
范	饭
目	呆 日
称	你 呈 陈
绪	蓄 续 诸 需
鹤	盒
煲	堡 包
啃	肯
棍	昆
鬼	瑰 归
呱	瓜
茭	交
o	0 a c p O
榛	秦
矮	爱 哎 唉 隘 短 特 哀 萎 挨
烷	皖 湾 碗 完
忻	祈
敌	底
极	及 机 级
栘	移
徐	絮 涂 许
株	珠
铍	皮 啵
耸	怂 送
酪	咯 格
珍	真 阵 诊
娃	哇
准	谆 凖 锥 淮
医	意 咦 一 匠 姨
深	沈 森 申 探 参 琛 身
嗅	臭 溴 休 秀
吭	亢 坑
柳	留
负	覆
锆	告
箱	相
敦	墩
G	C D
纠	久 旧
淇	其 激
故	股 姑
塌	榻 踏 他
川	钏 汌 州 传 串 穿
如	乳
荚	夹
枢	区 殊 柩 署 书
啼	剃 提 梯
吼	喉
临	诊 领 林 监
蛎	励 历 厉
拐	箉
刷	唰 耍 剧
统	痛 桶 通 充 铜 疮 同 流 铳
蔓	缦 漫 曼
叩	扣
蜈	无 吴 误
茴	回
鹰	英 莺 膺
蜗	莴 我 窝 涡
逸	忆
嘧	密 秘
贯	惯
剃	梯 涕 悌 剔
渐	捡 减 拣 浙 见
羹	庚 更 鲠
条	跳 眺 调 挑
褶	摺 辙
醌	鲲 昆
榆	瑜
攥	纂
旦	但
莨	良 浪 狼
兹	茨
够	钩 狗 苟
毫	亳
剔	剃 踢
雁	燕
蛤	哈 各
咔	卡
腑	腹
贪	谈 摊
漱	树 嗽 淑 濑 溯 署 涑 搜
茹	如
咖	咔 晚 卡 噶 加
吲	引
李	里
猫	苗 瞄 锚 喵 帽 狸 毛
希	稀 晞 西 杀
鳃	腮
愈	瑜 喻 育 偷 与 预 俞
袜	哇 靺 妹 瓦 抹
薰	熏
菱	绫 凌
宿	素 愫
馍	摸
飘	票 漂
识	时 式 枳
E	B F W
歧	技 其 岐 祁
朦	濛
触	出 处
懒	栏 獭 赖
岭	拎 玲
l	1 L i
闸	札 炸
芭	把 吧 巴
郎	浪 朗 狼
遥	摇 瑶
粽	综 宗 琮 棕
脒	咪
站	沾 战 占 粘
珀	坡 泊
苞	包
善	山 缮
纸	支 指
酱	桨 绛 奖 姜
侏	朱
别	莂
莎	纱 沙
训	力 驯 圳
蹲	尊 敦
八	巴 吧 扒 叭 入
瘟	揾 温
鳅	秋
＋	十
舞	物 五
战	站 占
然	燃
攒	赞
堕	坠 多
收	首 収
勾	句
呋	复 夫 扶
讲	将
炮	疱 泡
抚	扶
奎	喹
坨	拖 小 陀
河	何 和
陵	绫 凌
涂	土 图 途
颔	合
抠	扣 区
卤	鲁 庐 卢
场	肠
槐	愧 鬼 淮 䈭
豉	池 逗 支 鼓 枝 豆
猛	梦
摆	佰 罢
髂	掐 恰 䯊 客 揢
倦	卷
淌	躺 堂
炸	咋 诈
吊	调 掉
柴	紫
摊	瘫
抻	晨
厐	胖
丫	厊 Y 呀 吖
妙	秒
谈	痰
妲	坦
橄	敢 甘
决	绝 厥
纺	防
腩	南 楠
甚	肾
垃	拉
宾	滨
蟆	馍 摸 模 蚂
芙	肤 夫
檗	拨 辟 壁
韵	晕
昆	坤 困
孜	子 籽
吱	肢 支 枝
祸	锅 获 货
督	堵
涌	蛹 拥 勇
魇	炎 淹 胭
淹	掩 烟 腌
膻	檀
拧	宁
帮	邦
澈	撤
措	错
揭	接 竭
段	煅 端 短 断
哧	赤
乃	奶
端	耑 偳 断 揣 段
臆	意
蚁	以 仪
鳕	雪
菟	兔
s	x a z c S
玩	完
饼	并
刻	咳
馊	搜 嗖
私	咝 斯 撕
吻	文 温 稳
爪	瓜 抓
畜	出
芳	方
坤	捆 昆 琨 困
笕	现
羔	糕 羌
晰	析 唽
蝎	喝 歇 蟹
琳	林 淋
则	泽
辽	了 疗
撅	厥 蕨
乔	桥
证	症 征
癞	赖 濑
业	页 夜
凌	灵
蜊	利
挥	晖
梯	剃 涕 悌
漆	膝 栖 其
蜥	析
鲈	卢
扒	八
哨	俏 肖
桦	华
瑜	榆 喻 渝 逾 愉 俞
葫	户 胡
蟑	樟 章
跨	垮
颏	亥 劾 刻 颌 咳
蚜	牙
傍	磅
蹭	赠
纽	扭
楼	娄
商	熵 伤
叫	较 脚
蜇	折 蛰 哲
现	线
葛	隔 各
醚	谜 迷
蓬	缝
敝	蔽
僻	辟
君	军
亨	哼
品	拼 贫
庙	苗
蛙	哇
捡	检
濡	乳
伍	五
蒽	嗯 恩
椽	缘
桉	胺 安
评	平 苹 坪
叹	谈 炭
哚	朵
蜱	啤 卑
腈	晴
姑	估 故 菇 古
申	甲
泵	崩 揼
野	也 嘢 夜
府	附 付
盏	孟 栈
械	卸 泄
往	住
迈	脉 劢 麦
撑	称 乘 成 掌 秤
鲑	桂 蛙
蕨	撅
蒎	派
痊	全
滩	摊
浴	欲 俗
滚	棍 衮
溜	瘤 留
3	8
乱	栾 卵
姓	杏 性
榄	蓝 览
狮	师
腘	国
嗖	廋
缗	昬
控	空
豚	涿 臀 屯
墟	虚
衄	丑 衂
锤	捶 垂
痄	乍
狠	狼
稚	椎 直
6	b 9
秕	比
对	队 怼
拗	幼
虻	亡
框	眶
秽	岁
X	x ×
蔻	寇
沺	细
群	裙
校	较
寿	受
-	一
鲤	里
想	相
料	了 枓
饲	伺 斯 司
舱	仓 沧
之	支
仰	抑
莉	利
挞	闼
桶	通
羞	修
泳	永
帐	涨
暂	占 咱
吨	炖
配	陪
钗	拆
纱	莎 沙 砂
雅	呀 牙
惯	贯
濒	斌 频
缠	铲 厘 緾
忽	乎 勿
蚀	筮
羧	梭
馈	溃 愧
患	串 换
由	油
腚	定
哗	华
黎	梨
握	喔 屋
矿	狂 旷 框
蹈	稻 到 倒
累	类
莴	喔 涡 窝
央	秧
厅	汀
锭	定
沾	站 占
荠	齐 忌
怖	咘 布
茼	同
案	按
个	各 人
卷	倦
臣	巨
午	牛
穹	穷
操	燥
户	尸
殊	姝
者	昔
亡	芒
忡	肿
据	琚
跛	波 坡
胭	炎
跗	驸
藻	澡 噪
罂	应
珊	删
捻	念
好	郝 号
矾	帆 返 凡
被	贝 披 陂 备
悲	倍
凯	恺
探	谈 碳 深
滨	宾
都	抖
豁	霍
浊	冲 卓
迭	跌
K	k
胼	片 并
苄	边 卞
要	药
欠	气
蕾	雷
划	滑 化
荼	茶
奋	芬 愤
刹	杀
腻	膩
芯	心
柔	肉
钦	软
院	元 苑
窟	枯 库
翅	尺
号	好
社	设
饺	绞 姣
旱	焊
储	褚 潴
夷	姨 咦
葩	趴
捣	岛
氙	山
蠕	孺 儒
浙	哲
煅	段
武	舞
财	才
凡	烦
朱	珠 猪
五	无 伍 午 武
害	氦 嗐
钟	中 肿 祌
州	洲
螂	郎
从	丛
挖	哇 瓦
 	 
闻	问
宵	肖
聪	从 丛
炙	久
碰	砰 彭
U	O
承	呈
r	t R i
摁	嗯
轰	哄
氩	亚
桐	铜 同
噔	登
扳	坂 板
懵	蠓
蔽	敝 弊 闭 避
哽	更
啰	罗
鹿	麓 陆
溺	泥 弱
x	v
广	光 厂
秤	称
什	十
嘉	加
欢	还
签	芊
云	运 芸
骑	奇
弧	孤 狐
瘿	婴 樱
家	嫁 加
章	樟 障
蚧	阶
於	淤
夕	多
呀	牙
市	柿
拢	龙
哥	歌 各
了	子
及	极
俩	两
u	v n
铊	它 陀
份	分
粱	梁
搬	般
问	间
杯	环
淘	掏
寻	浔
慈	兹 磁
哩	理
王	汪 往
只	止
篇	偏
豹	报
秀	绣
荆	经
终	冬 钟
胝	低
悦	月 乐
昌	唱 毛
瘰	螺 累
卫	未
冈	岗 刚
研	妍
妆	壮
佛	坲
专	砖 转
楚	储
择	泽
巾	进
缄	碱
就	酒
偶	欧
敖	傲
菪	当
敲	乔
隧	遂
献	鲜
赝	雁
委	惟 萎
古	故
披	皮
帝	第
壕	豪
惠	慧
命	掵
脆	翠
捐	娟
吩	份
鲳	昌
佗	陀
拒	距
孪	栾
沛	伂
蝙	扁
兴	新
拦	烂
犁	梨
姬	即
几	凡
丧	桑
喊	汗
k	K
席	系
泔	甘
馏	留
瘸	却
庖	包
削	销 肖
庵	俺
臧	藏
告	高 诰
尚	上
嫉	极
w	v
雀	却
涣	换
喇	啦
泉	全
装	壮
搓	挫
俏	乔 悄
痞	批
迂	增 于
拴	栓
鞋	邪
存	纯 寸
读	独
镍	嗫
岑	今
鸪	故
矛	茅
蛳	斯
呤	令
霸	罢
守	收
杓	灼
蝠	富
萜	帖
邪	斜
翰	瀚
弗	佛
串	穿
韩	汉
蓣	预
獭	懒
阙	蒛
钳	阡
蓟	机
汪	王
答	瘩
酥	速 稣
蚓	引
逊	孙
浪	郎
搽	茶
属	蜀
榈	吕
赫	核
唯	惟
摸	模
羌	蜣
坎	砍
j	J
α	a
鳜	蕨
亲	秦
越	月
噬	适
拖	脱
蹒	慢
疕	庇
鄂	愕
毁	会
鳗	漫
改	该
掺	参
囱	卤
鲨	纱
Ⅰ	i
盈	影
皂	造
园	圆
饶	绕
5	S
箍	故
井	颈
濑	赖
为	伪 未
0	克
.	0
f	F
匐	福
噗	璞
媚	每
Q	q
携	歇
瓦	哇
冥	名
幸	悻
鲶	念
锡	易
欧	呕
绌	出
拌	半
招	昭
巯	硫
吖	丫
各	个
却	缺
鳔	飘
